#############################################################################################################################
#...............................................................................................%%%%%%%%%%%%%%%%%%..........#
#...........................................................................................................................#
###########............*................##################################.......................................############
#..........##%......#############.......##....................................%..#############...................#..........#
#..@.........%..........................#........................................................................#..........#
######.......%......................%...........................###########......................................#..........#
#............%.................................................#.................................................#########..#
#............%................................................#.............................................................#
#............%...............................................#..............................................................#
#############################################################################################################################