################
#............%.#
#..........><..#
#..@...*...><..#
#########..#####
________####