################
#%%%%%%%%....%.#
#..........><..#
#..@...*...><..#
################