#####################################################
#.........................><........................#
#%...........(............><.........)...........^..#
#%..##########################################%..####
#%..#%%%%%%%%%%%%%%%%%%%%%%%%%%%%%%%%%%%%%%%%%%.....#
#%..#.....................*.........................#
#%..#....)..^.........%#.....#%...............^.(...#
#%..#########.........%#######%...............#######
#%...................................(..............#
#%...........%###%........&........%###%............#
#%........(..%...........###...........%............#
#.......####..........%.......%..........####.......#
#.................................................(.#
####.............................................####
#.......^.........%......(.)......%.......(.^.......#
#%......####%...........#####...........%####......%#
#%..........%...)........%%%............%..........%#
#%............####%...............%####............%#
#...).^...........%......%%%......%.....^...)......%#
#######...........%...............%.....#########..%#
#.................%......%%%......%.............#..%#
#...............................................#..%#
#...........(......^....^.^.^....^..............#..%#
####...##########################################..%#
#..................................................%#
#.@.................................................#
#####################################################