#############################################################################################################################
#...............................................................................................%%%%%%%%%%%%%%%%%%..........#
#...)......................................................(................................................................#
###########............*................##################################.......................................############
#..........##%......#############.......##....................................%..#############...................#..........#
#............%..........................#...............................(........................................#..........#
######.......%......................%...........................###########......................................#..).......#
#............%.................................................#.................................................#########..#
#............%...........><...................................#.............................................................#
#............%...@.......><..................................#..............................................................#
#############################################################################################################################