################
#............%.#
#..........><..#
#..@...*...><..#
################