#####################################################
#.........................><........................#
#%...........(............><.........)..............#
#%..##########################################...####
#%..#...............................................#
#%..#.....................*.........................#
#%..#....)............%#.....#%.................(...#
#%..#########.........%#######%...............#######
#%....................%.......%.....(...............#
#%...........%####%...............%####%............#
#%........)..%....%...............%....%............#
#.......####.............................####.......#
#.......................(.&.).......................#
####..............%###############%..............####
#.................%...............%.......(.........#
#.......####%.....%...............%.....%####.......#
#...........%...)........%%%............%..........%#
#.............####%...............%####............%#
#...).............%......%%%......%.........)......%#
#######...........%...............%.....#########..%#
#.................%......%%%......%.............#..%#
#...............................................#..%#
#...........(...................................#..%#
####...##########################################..%#
#..................................................%#
#.@.................................................#
#####################################################