##################################
#%%%%%%%%%%%%%%%%%%%%%%%%%%%%%%%%#
#................................#
#%............................*..#
#%..#............................#
#%..#....).......................#
#%..#..%####..............####%..#
#%..#...............)............#
#%..#..........########..........#
#%..#.......................(....#
#%..#..%####..............####%..#
#%..#............................#
#%..#..........########..........#
#%..#....(.......................#
#%..#..%####..............####%..#
#%..#.............(..............#
#%..#..........########..........#
#%..#.......................)....#
#%..#..%####..............####%..#
#%..#............................#
#%..#............................#
#%..#.........).....)...........%#
#%..##########################..%#
#%..#........................#..%#
#%..#............)..........%#..%#
#%..#...##################..%#..%#
#%..#..................><#..%#..%#
#%..#.........(.....(..><#..%#..%#
#%..######################..%#..%#
#%..........................%#..%#
#................(...........#..%#
##############################..%#
#...............................%#
#%............(.....(............#
#%..##############################
#%...............................#
#................)..............%#
##############################..%#
#...............................%#
#..@.............................#
##################################