#############################################################################################################################
#...............................................................................................%%%%%%%%%%%%%%%%%%..........#
#...........................................................................................................................#
###########.............................##################################.......................................############
#..@.......##%......#############.......##....................................%..#############...................#..........#
#............%..........................#........................................................................#..........#
######.......%......................%...........................###########......................................########...#
#............%.................................................#............................................................#
#............%................................................#.............................................................#
#............%...............................................#..............................................................#
#############################################################################################################################